.................................
. .                             .
. ... ......................... .
.   . .           .   .       . .
... . . ......... . . . . ..... .
. . . . .       .   . . .     . .
. . . . . ... ..... ... ..... . .
. . . . .   . .   . .   .   . . .
. . . . ... . . . . . ... . . . .
. .   .   . . . .   .     . . . .
. ....... . ... ........... . . .
.         .   .           . . . .
..... ..... . ........... . . . .
.     .   . .           . . . . .
. ..... ... ..... . ... . . . . .
.     .     . .   . .   . . .   .
. ... ... ... . . ..... . . .....
. . .   .     . . .   . . .     .
. . ... ..... . . . . . . ..... .
. .   . .     . . . . . .     . .
. . . . ... . . . . . ....... . .
. . . .   . . . . . .       . . .
. ... ... ..... . . ..... ... . .
. .     . .     . . .   .   . . .
. . ... . . ... ... . ..... . . .
.   .   . .   . .   .     . . . .
..... ... ... . . ..... ... . . .
.   .   .   . . .       .   . . .
. . ... ... . ... ..... . ... . .
. .   .   . .     .   . .     . .
. ....... . ....... . ......... .
.         .         .           .
.................................
